0, 1, 1, 1, 1, 1, 1, 1, 1, 1, 1, 1, 1, 1, 1, 1, 1, 1, 1, 1, 1, 1, 1, 1, 1, 1, 1, 1, 1, 1, 1, 2,
8, 32, 33, 33, 33, 33, 33, 33, 33, 33, 33, 33, 33, 33, 33, 33, 33, 33, 33, 33, 33, 33, 33, 33, 33, 33, 33, 33, 33, 33, 34, 10,
8, 40, 41, 41, 41, 41, 41, 41, 41, 41, 41, 41, 41, 41, 41, 41, 41, 41, 41, 41, 41, 41, 41, 41, 41, 41, 41, 41, 41, 41, 42, 10,
8, 40, 41, 41, 41, 41, 41, 41, 41, 41, 41, 41, 41, 41, 41, 41, 41, 41, 41, 41, 41, 41, 41, 41, 41, 41, 41, 41, 41, 41, 42, 10,
8, 40, 41, 41, 41, 41, 41, 41, 41, 41, 41, 41, 41, 41, 41, 41, 41, 41, 41, 41, 41, 41, 41, 41, 41, 41, 41, 41, 41, 41, 42, 10,
8, 40, 41, 41, 41, 41, 41, 41, 41, 41, 41, 41, 41, 41, 41, 41, 41, 41, 41, 41, 41, 41, 41, 41, 41, 41, 41, 41, 41, 41, 42, 10,
8, 40, 41, 41, 41, 41, 36, 37, 37, 37, 37, 37, 37, 37, 38, 41, 41, 36, 37, 37, 37, 37, 37, 37, 37, 38, 41, 41, 41, 41, 42, 10,
8, 40, 41, 41, 41, 41, 44, 45, 45, 45, 45, 45, 45, 45, 46, 41, 41, 44, 45, 45, 45, 45, 45, 45, 45, 46, 41, 41, 41, 41, 42, 10,
8, 40, 41, 41, 41, 41, 44, 45, 45, 45, 45, 45, 45, 45, 46, 41, 41, 44, 45, 45, 45, 45, 45, 45, 45, 46, 41, 41, 41, 41, 42, 10,
8, 40, 41, 41, 41, 41, 44, 45, 45, 45, 45, 45, 45, 45, 46, 41, 41, 44, 45, 45, 45, 45, 45, 45, 45, 46, 41, 41, 41, 41, 42, 10,
8, 40, 41, 41, 41, 41, 44, 45, 45, 45, 45, 45, 45, 45, 46, 41, 41, 44, 45, 45, 45, 45, 45, 45, 45, 46, 41, 41, 41, 41, 42, 10,
8, 40, 41, 41, 41, 41, 44, 45, 45, 45, 45, 45, 45, 45, 46, 41, 41, 44, 45, 45, 45, 45, 45, 45, 45, 46, 41, 41, 41, 41, 42, 10,
8, 40, 41, 41, 41, 41, 44, 45, 45, 45, 45, 45, 45, 45, 46, 41, 41, 44, 45, 45, 45, 45, 45, 45, 45, 46, 41, 41, 41, 41, 42, 10,
8, 40, 41, 41, 41, 41, 44, 45, 45, 45, 45, 45, 45, 45, 46, 41, 41, 44, 45, 45, 45, 45, 45, 45, 45, 46, 41, 41, 41, 41, 42, 10,
8, 40, 41, 41, 41, 41, 52, 53, 53, 53, 53, 53, 53, 53, 54, 41, 41, 52, 53, 53, 53, 53, 53, 53, 53, 54, 41, 41, 41, 41, 42, 10,
8, 40, 41, 41, 41, 41, 41, 41, 41, 41, 41, 41, 41, 41, 41, 41, 41, 41, 41, 41, 41, 41, 41, 41, 41, 41, 41, 41, 41, 41, 42, 10,
8, 40, 41, 41, 41, 41, 41, 41, 41, 41, 41, 41, 41, 41, 41, 41, 41, 41, 41, 41, 41, 41, 41, 41, 41, 41, 41, 41, 41, 41, 42, 10,
8, 40, 41, 41, 41, 41, 36, 37, 37, 37, 37, 37, 37, 37, 38, 41, 41, 36, 37, 37, 37, 37, 37, 37, 37, 38, 41, 41, 41, 41, 42, 10,
8, 40, 41, 41, 41, 41, 44, 45, 45, 45, 45, 45, 45, 45, 46, 41, 41, 44, 45, 45, 45, 45, 45, 45, 45, 46, 41, 41, 41, 41, 42, 10,
8, 40, 41, 41, 41, 41, 44, 45, 45, 45, 45, 45, 45, 45, 46, 41, 41, 44, 45, 45, 45, 45, 45, 45, 45, 46, 41, 41, 41, 41, 42, 10,
8, 40, 41, 41, 41, 41, 44, 45, 45, 45, 45, 45, 45, 45, 46, 41, 41, 44, 45, 45, 45, 45, 45, 45, 45, 46, 41, 41, 41, 41, 42, 10,
8, 40, 41, 41, 41, 41, 44, 45, 45, 45, 45, 45, 45, 45, 46, 41, 41, 44, 45, 45, 45, 45, 45, 45, 45, 46, 41, 41, 41, 41, 42, 10,
8, 40, 41, 41, 41, 41, 44, 45, 45, 45, 45, 45, 45, 45, 46, 41, 41, 44, 45, 45, 45, 45, 45, 45, 45, 46, 41, 41, 41, 41, 42, 10,
8, 40, 41, 41, 41, 41, 44, 45, 45, 45, 45, 45, 45, 45, 46, 41, 41, 44, 45, 45, 45, 45, 45, 45, 45, 46, 41, 41, 41, 41, 42, 10,
8, 40, 41, 41, 41, 41, 44, 45, 45, 45, 45, 45, 45, 45, 46, 41, 41, 44, 45, 45, 45, 45, 45, 45, 45, 46, 41, 41, 41, 41, 42, 10,
8, 40, 41, 41, 41, 41, 52, 53, 53, 53, 53, 53, 53, 53, 54, 41, 41, 52, 53, 53, 53, 53, 53, 53, 53, 54, 41, 41, 41, 41, 42, 10,
8, 40, 41, 41, 41, 41, 41, 41, 41, 41, 41, 41, 41, 41, 41, 41, 41, 41, 41, 41, 41, 41, 41, 41, 41, 41, 41, 41, 41, 41, 42, 10,
8, 40, 41, 41, 41, 41, 41, 41, 41, 41, 41, 41, 41, 41, 41, 41, 41, 41, 41, 41, 41, 41, 41, 41, 41, 41, 41, 41, 41, 41, 42, 10,
8, 40, 41, 41, 41, 41, 41, 41, 41, 41, 41, 41, 41, 41, 41, 41, 41, 41, 41, 41, 41, 41, 41, 41, 41, 41, 41, 41, 41, 41, 42, 10,
8, 40, 41, 41, 41, 41, 41, 41, 41, 41, 41, 41, 41, 41, 41, 41, 41, 41, 41, 41, 41, 41, 41, 41, 41, 41, 41, 41, 41, 41, 42, 10,
8, 40, 41, 41, 41, 41, 41, 41, 41, 41, 41, 41, 41, 41, 41, 41, 41, 41, 41, 41, 41, 41, 41, 41, 41, 41, 41, 41, 41, 41, 42, 10,
16, 17, 17, 17, 17, 17, 17, 17, 17, 17, 17, 17, 17, 17, 17, 17, 17, 17, 17, 17, 17, 17, 17, 17, 17, 17, 17, 17, 17, 17, 17, 18,