20
20
69, 70, 71, 14, 12, 69, 70, 71, 69, 70, 71, 69, 70, 71, 69, 70, 71, 69, 70, 71,
71, 55, 65, 14, 12, 65, 65, 65, 65, 65, 65, 65, 65, 65, 65, 3, 5, 65, 64, 69,
71, 55, 65, 60, 50, 65, 65, 69, 70, 71, 65, 65, 65, 65, 3, 4, 4, 5, 64, 69,
71, 55, 65, 42, 43, 44, 65, 69, 70, 71, 3, 76, 76, 5, 14, 16, 16, 50, 64, 69,
71, 55, 65, 54, 71, 56, 76, 76, 76, 76, 50, 65, 65, 14, 16, 16, 16, 50, 64, 69,
71, 55, 65, 66, 67, 68, 65, 65, 65, 65, 14, 76, 76, 29, 14, 16, 16, 50, 64, 69,
71, 55, 65, 65, 69, 70, 71, 65, 65, 65, 51, 65, 65, 65, 27, 28, 28, 29, 64, 69,
71, 55, 65, 65, 69, 70, 71, 65, 65, 65, 51, 65, 65, 65, 65, 51, 51, 65, 64, 69,
71, 55, 65, 65, 3, 40, 40, 5, 65, 65, 51, 65, 65, 65, 65, 51, 51, 65, 64, 69,
71, 55, 65, 65, 14, 16, 16, 16, 76, 76, 50, 65, 69, 70, 71, 51, 51, 65, 64, 69,
71, 55, 65, 65, 14, 16, 16, 16, 65, 65, 51, 65, 69, 70, 71, 51, 51, 65, 64, 69,
71, 55, 65, 65, 27, 53, 53, 29, 65, 65, 51, 65, 69, 70, 71, 51, 51, 65, 64, 69,
71, 55, 65, 65, 65, 65, 65, 65, 65, 65, 51, 65, 65, 65, 65, 51, 51, 65, 64, 69,
71, 55, 65, 42, 76, 76, 76, 76, 76, 76, 16, 77, 65, 65, 3, 4, 4, 5, 64, 69,
71, 55, 65, 51, 65, 65, 65, 65, 65, 65, 51, 65, 65, 65, 14, 16, 16, 50, 64, 69,
71, 55, 65, 51, 65, 65, 65, 65, 65, 65, 51, 65, 65, 65, 14, 16, 16, 50, 64, 69,
75, 76, 76, 16, 76, 76, 77, 65, 65, 65, 51, 65, 65, 65, 14, 16, 16, 50, 64, 69,
71, 55, 65, 63, 65, 65, 65, 65, 65, 65, 51, 65, 65, 65, 27, 52, 16, 29, 64, 69,
71, 55, 65, 65, 65, 65, 65, 65, 75, 76, 16, 76, 76, 76, 76, 76, 62, 65, 64, 69,
69, 70, 71, 80, 69, 70, 71, 69, 70, 71, 63, 69, 70, 71, 80, 80, 69, 70, 71, 69,
